1111111111111111111111111111111111111111
1111111111111111111111111111111111111111
1111111111111111111111111111111111111111
1111111111111111111111111111111111111111
1111111111111111111111111111111111111111
1111111111111111111111111111111111111111
1111111111111111111111111111111111111111
1111111100000000000000000000000011111111
1111111103111121111211111111121011111111
1111111101111131111112211111211011111111
1111111104111121131112211211111011111111
1111111101111111111111111111111011111111
1111111101121111311221111211111011111111
1111111101111121111131111111311011111111
1111111101111111111111111211111011111111
1111111101111211111111111111111011111111
1111111100000000000000111110000011111111
1111111101112121111111111111111011111111
1111111101111111111112111111111011111111
1111111101113111111113111113111011111111
1111111101112111111111111111111011111111
1111111101111111111111111121111011111111
1111111101311111111112111111111011111111
1111111101111111131111111111111011111111
1111111101111210000000000121111011111111
1111111101111111111111111111111011111111
1111111101111111121111111111311011111111
1111111101112111111111111111111011111111
1111111101111111111111112111144011111111
1111111101111211111311111111144011111111
1111111100000000000000000000000011111111
1111111111111111111111111111111111111111
1111111111111111111111111111111111111111
1111111111111111111111111111111111111111
1111111111111111111111111111111111111111
1111111111111111111111111111111111111111
1111111111111111111111111111111111111111
1111111111111111111111111111111111111111

/*Legende:
0:Wall
1:Ground
2:Rock
3:Diamond
4:Background*/
