000000000000000000000000
031111211112111111111210
011111311111122111112110
041111211311122112111110
011111111111111111111110
011211113112211112111110
011111211111311111113110
011111111111111112111110
011112111111111111111110
000000000000001111100000
011121211111111111111110
011111111111121111111110
011131111111131111131110
011121111111111111111110
011111111111111111211110
013111111111121111111110
011111111311111111111110
011112100000000001211110
011111111111111111111110
011111111211111111113110
011121111111111111111110
011111111111111121111440
011112111113111111111440
000000000000000000000000

/* Legende :
0 : Wall
1 : Ground
2 : Rock
3 : Diamond
4 : Background */
