000000000000000000000000
021141111111111111111110
011114112111114111111110
041000000000000000000000
011111311111211111311110
012112311111114111111110
011111112111311111211110
011112111121111212111110
011114111114111111411110
011111131114111111111110
011121111111121132111110
011111111111111111111110
011114111111114111114110
011111114111111111411110
012111111111121111111110
011121111114111111112110
011114113111211121111110
011111141111111311411110
011111111111141111112110
000000000000000000011110
011113111114111111111110
044111211111111111141110
044111111111211411113110
000000000000000000000000

/* Legende :
0 : Wall
1 : Ground
2 : Rock
3 : Diamond
4 : Background */
