000000000000000000000000
011101211131112111311140
011110111141111121111110
011000000000030000000000
011121112111111111131110
011411211111411111121110
012111411110112111411110
011111111110111111111210
011121111121141101112110
011114111111111211131110
011112111412111411111110
011113111111112111113110
010111141111311111412110
011111111411111111011110
011111211011101111111440
014111111111111141110440
011111410110121111111110
011111113101111111411110
011101111111201111111110
000000000000000000011110
011101111110111111111110
011114111111111110114110
011111111111141113111110
000000000000000000000000

/* Legende :
0 : Wall
1 : Ground
2 : Rock
3 : Diamond
4 : Background */
