1111111111111111111111111111111111111111
1111111111111111111111111111111111111111
1111111111111111111111111111111111111111
1111111111111111111111111111111111111111
1111111111111111111111111111111111111111
1111111111111111111111111111111111111111
1111111111111111111111111111111111111111
1111111100000000000000000000000011111111
1111111101110121113111211131114011111111
1111111101111011114111112111111011111111
1111111101100000000003000000000011111111
1111111101112111211111111113111011111111
1111111101141121111141111112111011111111
1111111101211141111011211141111011111111
1111111101111111111011111111121011111111
1111111101112111112114110111211011111111
1111111101111411111111121113111011111111
1111111101111211141211141111111011111111
1111111101111311111111211111311011111111
1111111101011114111131111141211011111111
1111111101111111141111111101111011111111
1111111101111121101110111111144011111111
1111111101411111111111114111044011111111
1111111101111141011012111111111011111111
1111111101111111310111111141111011111111
1111111101110111111120111111111011111111
1111111100000000000000000001111011111111
1111111101110111111011111111111011111111
1111111101111411111111111011411011111111
1111111101111111111114111311111011111111
1111111100000000000000000000000011111111
1111111111111111111111111111111111111111
1111111111111111111111111111111111111111
1111111111111111111111111111111111111111
1111111111111111111111111111111111111111
1111111111111111111111111111111111111111
1111111111111111111111111111111111111111
1111111111111111111111111111111111111111



/* Legende :
0 : Wall
1 : Ground
2 : Rock
3 : Diamond
4 : Background */
