1111111111111111111111111111111111111111
1111111111111111111111111111111111111111
1111111111111111111111111111111111111111
1111111111111111111111111111111111111111
1111111111111111111111111111111111111111
1111111111111111111111111111111111111111
1111111111111111111111111111111111111111
1111111100000000000000000000000011111111
1111111101111112111111111121111011111111
1111111101112111411111411111111011111111
1111111101111111211111111211111011111111
1111111101111111311111111111111011111111
1111111101111121111111102111111011111111
1111111101111111111111111111111011111111
1111111101111101144411101113111011111111
1111111101112111145411111211111011111111
1111111101111111144411111114111011111111
1111111101111111111111111211111011111111
1111111101111011111111111111111011111111
1111111101011211111111111131111011111111
1111111101111111413111111111411011111111
1111111101114111111211114112111011111111
1111111101311111111111111111011011111111
1111111101114111111144411111111011111111
1111111101111111111145411121121011111111
1111111101111141101144411111111011111111
1111111100000000000000000001111011111111
1111111101110111110112111141111011111111
1111111101114011111110111311111011111111
1111111101111111110111111111211011111111
1111111100000000000000000000000011111111
1111111111111111111111111111111111111111
1111111111111111111111111111111111111111
1111111111111111111111111111111111111111
1111111111111111111111111111111111111111
1111111111111111111111111111111111111111
1111111111111111111111111111111111111111
1111111111111111111111111111111111111111

/*Legende:
0:Wall
1:Ground
2:Rock
3:Diamond
4:Background
5:Mobs*/
