000000000000000000000000
011111121111111111211110
011121114111114111111110
011111112111111112111110
011111113111111111111110
011111211111111021111110
011111111111111111111110
011111011444111011131110
011121111454111112111110
011111111444111111141110
011111111111111112111110
011110111111111111111110
010112111111111111311110
011111114131111111114110
011141111112111141121110
013111111111111111110110
011141111111444111111110
011111111111454111211210
011111411011444111111110
000000000000000000011110
011101111101121111411110
011140111111101113111110
011111111101111111112110
000000000000000000000000

/* Legende :
0 : Wall
1 : Ground
2 : Rock
3 : Diamond
4 : Background 
5 : Mobs */
