000000000000000000000000
011211211111111211211110
011111011444111011131110
011121111454111112111110
011111111444111111141110
011311112111111121111110
011121111111111111111110
011111211111113111111110
011113211111111111111110
011111111121111112111110
011511111211121111111110
012111111111111211111110
011111011444111014444410
011121111354111114453410
011111111444111114444410
011122111111111111111110
011131112111111211111110
011111311111321112111110
011511121111111211111110
011111211112121111211110
011121131121121111111110
011110111115101121111110
011111511111111111115110
000000000000000000000000

/* Legende :
0 : Wall
1 : Ground
2 : Rock
3 : Diamond
4 : Background 
5 : Mobs */
