1111111111111111111111111111111111111111
1111111111111111111111111111111111111111
1111111111111111111111111111111111111111
1111111111111111111111111111111111111111
1111111111111111111111111111111111111111
1111111111111111111111111111111111111111
1111111111111111111111111111111111111111
1111111100000000000000000000000011111111
1111111101121121111111121121111011111111
1111111101111101144411101113111011111111
1111111101112111145411111211111011111111
1111111101111111144411111114111011111111
1111111101131111211111112111111011111111
1111111101112111111111111111111011111111
1111111101111121111111311111111011111111
1111111101111321111111111111111011111111
1111111101111111112111111211111011111111
1111111101151111121112111111111011111111
1111111101211111111111121111111011111111
1111111101111101144411101444441011111111
1111111101112111135411111445341011111111
1111111101111111144411111444441011111111
1111111101112211111111111111111011111111
1111111101113111211111121111111011111111
1111111101111131111132111211111011111111
1111111101151112111111121111111011111111
1111111101111121111212111121111011111111
1111111101112113112112111111111011111111
1111111101111011111510112111111011111111
1111111101111151111111111111511011111111
1111111100000000000000000000000011111111
1111111111111111111111111111111111111111
1111111111111111111111111111111111111111
1111111111111111111111111111111111111111
1111111111111111111111111111111111111111
1111111111111111111111111111111111111111
1111111111111111111111111111111111111111
1111111111111111111111111111111111111111

/*Legende:
0:Wall
1:Ground
2:Rock
3:Diamond
4:Background
5:Mobs*/
